000000000000000000000000000000000000000000000000000000000000000000000000000000000000000000000000000000000000000000000000000000000000000000000000000000000000000000000000000000000000000000000000000000000000000000000000000000000000000000000000000000000000000000000000000000000000000000000000000000000000000000000000000000000000000000000000000000000000000000000000000
000000000000000000000000000000000000000000000000000000000000000000000000000000000000000000000000000000000000000000000000000000000000000000000000000000000000000000000000000000000000000000000000000000000000000000000000000000000000000000000000000000000000000000000000000000000000000000000000000000000000000000000000000000000000000000000000000000000000000000000000000
000000000000000000000000000000000000000000000000300000000000000000000000000000000000000000000000000000000000000000000000000000000000000000000000000000000000000000000000000000000000000000000000000000000000000000000000000000000000000000000000000000000000000000000000000000000000000000000000000000000000011000000000000000000000000000000000000000000000000000000000000
000000000000000000000000000000000000000000000000000000000000000000000000000000000000000000000000000000000000000000000000000000000000000000000000000000000000022222220002223000000000000000000000000003000000000000022220000233200000000000000000000000000000000000000000000000000000000000000000000000000000111000000000000000000000000000000000000000000000000000000000000
000000000000000000000000000000000000000000000000000000000000000000000000000000000000000000000000000000000000000000000000000000000000000000000000000000000000000000000000000000000000000000000000000000000000000000000000000000000000000000000000000000000000000000000000000000000000000000000000000000000001111000000000000000000000000000000000000000000000000000000000000
000000000000000000000000000000000000000000000000000000000000000000000000000000000000000000000000088000000000000000000008800000000000000000000000000000000000000000000000000000000000000000000000000000000000000000000000000000000000000000000000000000000000000000000000000000000000000000000000000000000011111000000000000000000000000000001111100000000000000000000000000
000000000000000000000000000000030000000000000023232000000000000000000000000000000000008800000000045000000000000000000004500000000000003000000000000000000023200000000000002000000000000023000000030003000300000020000000000022000000000100001000000000001100100000000000000000000000000000000000000000000111111000000000000000000000000000000111000000000000000000000000000
000000000000000000000000000000000000000000000000000000000000000000000880000000000000004500000000067000000000000000000006700000000000000000000800000000000000000000000000000000000000000000000000000000000000000000000000000000000000001100001100000000011100110000000000000022320000000000000000000000001111111000000000000000000000000000001111100000000000000000000000000
000000000000000000000000000000000000000000000000000000000000000000000450000000000000006700000000067000000000000000000006700000000000000000008080000000000000000000000000000000000000000000000000000000000000000000000000000000000000011100001110000000111100111000004500000000000000000000000004500000011111111000000000000000000000000000001101100000000000000000000000000
000000000000000000000000000000000000000000000000000000000000000000000670000000000000006700000000067000000000000000000006700000000000000000000000000000000000000000000000000000000000000000000000000000000000000000000000000000000000111100001111000001111100111100006700000000000000000000000006700000111111111000000000000000000000000000001101100000000000000000000000000
111111110011111111111111111111111111111111111111111111111111111111111111111111111111111111111111111111111111111111111111111111111111111111110001111111111111111111100011111111111111111111111111111111111111111111111111111111111111111111111111111111111111111111111111111111111111111111111111111111111111111111111111111111111111111111111111111111111111111111111111111
111111110011111111111111111111111111111111111111111111111111111111111111111111111111111111111111111111111111111111111111111111111111111111110001111111111111111111100011111111111111111111111111111111111111111111111111111111111111111111111111111111111111111111111111111111111111111111111111111111111111111111111111111111111111111111111111111111111111111111111111111